01 01 01 01 01 01 01 01 01 01 01 01 01 01 01 01 01 01 01 01 01 01 01 01 01 01 01 01 01 01 01 01 01 01 01 01 01 01 01 01 01 01 01 01 01 01 01 01 01 01 01 01 01 01 01
01 35 25 25 25 25 25 25 25 25 25 25 25 25 25 25 25 25 25 25 25 25 25 25 25 36 01 01 01 35 25 25 25 25 25 25 25 25 25 25 25 25 25 25 25 25 25 25 25 25 25 25 25 36 01
01 15 02 26 02 26 02 26 02 26 02 26 02 26 02 26 02 26 02 26 02 26 02 26 02 17 01 01 01 15 02 26 02 26 02 26 02 26 02 26 02 26 02 26 02 26 02 26 02 26 02 26 02 17 01
01 15 16 33 27 27 27 27 27 27 27 34 16 33 27 27 27 27 27 27 27 27 27 34 16 17 01 01 01 15 16 34 27 27 27 27 27 27 27 27 27 34 16 33 27 27 27 27 27 27 27 34 16 17 01
01 15 02 17 01 01 01 01 01 01 01 15 02 17 01 01 01 01 01 01 01 01 01 15 02 17 01 01 01 15 02 17 01 01 01 01 01 01 01 01 01 15 02 17 01 01 01 01 01 01 01 15 02 17 01
01 15 16 17 01 01 01 01 01 01 01 15 16 17 01 01 01 01 01 01 01 01 01 15 16 17 01 01 01 15 16 17 01 01 01 01 01 01 01 01 01 15 16 17 01 01 01 01 01 01 01 15 16 17 01
01 15 02 17 01 01 01 01 01 01 01 15 02 17 01 01 01 01 01 01 01 01 01 15 02 17 01 01 01 15 02 17 01 01 01 01 01 01 01 01 01 15 02 17 01 01 01 01 01 01 01 15 02 17 01
01 15 16 17 01 01 01 01 01 01 01 15 16 17 01 01 01 01 01 01 01 01 01 15 16 17 01 01 01 15 16 17 01 01 01 01 01 01 01 01 01 15 16 17 01 01 01 01 01 01 01 15 16 17 01
01 15 02 17 01 01 01 01 01 01 01 15 02 17 01 01 01 01 01 01 01 01 01 15 02 17 01 01 01 15 02 17 01 01 01 01 01 01 01 01 01 15 02 17 01 01 01 01 01 01 01 15 02 17 01
01 15 16 32 25 25 25 25 25 25 25 31 16 32 25 25 25 25 25 25 25 25 25 31 16 32 25 25 25 31 16 32 25 25 25 25 25 25 25 25 25 31 16 32 25 25 25 25 25 25 25 31 16 17 01
01 15 02 26 02 26 02 26 02 26 02 26 02 26 02 26 02 26 02 26 02 26 02 26 02 26 02 26 02 26 02 26 02 26 02 26 02 26 02 26 02 26 02 26 02 26 02 26 02 26 02 26 02 17 01
01 15 16 33 27 27 27 27 27 27 27 34 16 33 27 27 27 34 16 33 27 27 27 27 27 27 27 27 27 27 27 27 27 27 27 34 16 33 27 27 27 34 16 33 27 27 27 27 27 27 27 34 16 17 01
01 15 02 17 01 01 01 01 01 01 01 15 02 17 01 01 01 15 02 17 01 01 01 01 01 01 01 01 01 01 01 01 01 01 01 15 02 17 01 01 01 15 02 17 01 01 01 01 01 01 01 15 02 17 01
01 15 16 17 01 01 01 01 01 01 01 15 16 17 01 01 01 15 16 17 01 01 01 01 01 01 01 01 01 01 01 01 01 01 01 15 16 17 01 01 01 15 16 17 01 01 01 01 01 01 01 15 16 17 01
01 15 02 17 01 01 01 01 01 01 01 15 02 17 01 01 01 15 02 17 01 01 01 01 01 01 01 01 01 01 01 01 01 01 01 15 02 17 01 01 01 15 02 17 01 01 01 01 01 01 01 15 02 17 01
01 15 16 32 25 25 25 25 25 25 25 31 16 17 01 01 01 15 16 32 25 25 25 25 25 36 01 01 01 35 25 25 25 25 25 31 16 17 01 01 01 15 16 32 25 25 25 25 25 25 25 31 16 17 01
01 15 02 26 02 26 02 26 02 26 02 26 02 17 01 01 01 15 02 26 02 26 02 26 02 17 01 01 01 15 02 26 02 26 02 26 02 17 01 01 01 15 02 26 02 26 02 26 02 26 02 26 02 17 01
01 38 27 27 27 27 27 27 27 27 27 34 16 17 01 01 01 38 27 27 27 27 27 34 16 17 01 01 01 15 16 33 27 27 27 27 27 37 01 01 01 15 16 33 27 27 27 27 27 27 27 27 27 37 01
01 01 01 01 01 01 01 01 01 01 01 15 02 17 01 01 01 01 01 01 01 01 01 15 16 17 01 01 01 15 16 17 01 01 01 01 01 01 01 01 01 15 02 17 01 01 01 01 01 01 01 01 01 01 01
01 01 01 01 01 01 01 01 01 01 01 15 16 17 01 01 01 01 01 01 01 01 01 15 16 17 01 01 01 15 16 17 01 01 01 01 01 01 01 01 01 15 16 17 01 01 01 01 01 01 01 01 01 01 01
01 01 01 01 01 01 01 01 01 01 01 15 02 17 01 01 01 01 01 01 01 01 01 15 16 17 01 01 01 15 16 17 01 01 01 01 01 01 01 01 01 15 02 17 01 01 01 01 01 01 01 01 01 01 01
01 01 01 01 01 01 01 01 01 01 01 15 16 32 25 25 25 25 25 25 25 25 25 31 16 32 25 25 25 31 16 32 25 25 25 25 25 25 25 25 25 31 16 17 01 01 01 01 01 01 01 01 01 01 01
01 01 01 01 01 01 01 01 01 01 01 15 02 26 26 26 26 26 26 26 26 26 26 26 26 26 26 26 26 26 26 26 26 26 26 26 26 26 26 26 26 26 02 17 01 01 01 01 01 01 01 01 01 01 01
01 01 01 01 01 01 01 01 01 01 01 15 16 33 27 27 27 34 16 33 27 27 27 27 27 27 34 16 33 27 27 27 27 27 27 34 16 33 27 27 27 34 16 17 01 01 01 01 01 01 01 01 01 01 01
01 01 01 01 01 01 01 01 01 01 01 15 02 17 01 01 01 15 16 17 01 01 01 01 01 01 15 16 17 01 01 01 01 01 01 15 16 17 01 01 01 15 02 17 01 01 01 01 01 01 01 01 01 01 01
01 01 01 01 01 01 01 01 01 01 01 15 16 17 01 01 01 15 16 17 01 35 25 25 25 25 31 16 32 25 25 25 25 36 01 15 16 17 01 01 01 15 16 17 01 01 01 01 01 01 01 01 01 01 01
01 01 01 01 01 01 01 01 01 01 01 15 02 17 01 01 01 15 16 17 01 15 26 26 26 26 26 26 26 26 26 26 16 17 01 15 16 17 01 01 01 15 02 17 01 01 01 01 01 01 01 01 01 01 01
01 01 01 01 01 01 01 01 01 01 01 15 16 17 01 01 01 15 16 17 01 15 16 33 27 27 27 27 27 27 27 34 16 17 01 15 16 17 01 01 01 15 16 17 01 01 01 01 01 01 01 01 01 01 01
01 01 01 01 01 01 01 01 01 01 01 15 02 17 01 01 01 15 16 17 01 15 16 17 01 01 01 01 01 01 01 15 16 17 01 15 16 17 01 01 01 15 02 17 01 01 01 01 01 01 01 01 01 01 01
01 01 01 01 01 01 01 01 01 01 01 15 16 17 01 01 01 15 16 32 25 31 16 17 01 01 01 01 01 01 01 15 16 32 25 31 16 17 01 01 01 15 16 17 01 01 01 01 01 01 01 01 01 01 01
01 01 01 01 01 01 01 01 01 01 01 15 02 17 01 01 01 15 16 26 26 26 16 17 01 01 01 01 01 01 01 15 16 26 26 26 16 17 01 01 01 15 02 17 01 01 01 01 01 01 01 01 01 01 01
01 01 01 01 01 01 01 01 01 01 01 15 16 17 01 01 01 15 16 33 27 27 27 37 01 01 01 01 01 01 01 38 27 27 27 34 16 17 01 01 01 15 16 17 01 01 01 01 01 01 01 01 01 01 01
01 01 01 01 01 01 01 01 01 01 01 15 02 17 01 01 01 15 16 17 01 01 01 01 01 01 01 01 01 01 01 01 01 01 01 15 16 17 01 01 01 15 02 17 01 01 01 01 01 01 01 01 01 01 01
01 01 01 01 01 01 01 01 01 01 01 15 16 32 25 25 25 31 16 32 25 25 25 25 25 25 25 25 25 25 25 25 25 25 25 31 16 32 25 25 25 31 16 17 01 01 01 01 01 01 01 01 01 01 01
01 01 01 01 01 01 01 01 01 01 01 15 02 26 26 26 26 26 16 26 26 26 26 26 26 26 26 26 26 26 26 26 26 26 26 26 16 26 26 26 26 26 02 17 01 01 01 01 01 01 01 01 01 01 01
01 01 01 01 01 01 01 01 01 01 01 15 16 33 27 27 27 34 16 33 27 27 27 27 27 27 27 27 27 27 27 27 27 27 27 34 16 33 27 27 27 34 16 17 01 01 01 01 01 01 01 01 01 01 01
01 01 01 01 01 01 01 01 01 01 01 15 02 17 01 01 01 15 16 17 01 01 01 01 01 01 01 01 01 01 01 01 01 01 01 15 16 17 01 01 01 15 02 17 01 01 01 01 01 01 01 01 01 01 01
01 01 01 01 01 01 01 01 01 01 01 15 16 17 01 01 01 15 16 17 01 01 01 01 01 01 01 01 01 01 01 01 01 01 01 15 16 17 01 01 01 15 16 17 01 01 01 01 01 01 01 01 01 01 01
01 01 01 01 01 01 01 01 01 01 01 15 02 17 01 01 01 15 16 17 01 01 01 01 01 01 01 01 01 01 01 01 01 01 01 15 16 17 01 01 01 15 02 17 01 01 01 01 01 01 01 01 01 01 01
01 35 25 25 25 25 25 25 25 25 25 31 16 32 25 25 25 31 16 32 25 25 25 25 25 36 01 01 01 35 25 25 25 25 25 31 16 32 25 25 25 31 16 32 25 25 25 25 25 25 25 25 25 36 01
01 15 02 26 02 26 02 26 02 26 02 26 02 26 02 26 02 26 02 26 02 26 02 26 02 17 01 01 01 15 02 26 02 26 02 26 02 26 02 26 02 26 02 26 02 26 02 26 02 26 02 26 02 17 01
01 15 16 33 27 27 27 27 27 27 27 34 16 33 27 27 27 27 27 27 27 27 27 34 16 17 01 01 01 15 16 33 27 27 27 27 27 27 27 27 27 34 16 33 27 27 27 27 27 27 27 34 16 17 01
01 15 02 17 01 01 01 01 01 01 01 15 02 17 01 01 01 01 01 01 01 01 01 15 02 17 01 01 01 15 02 17 01 01 01 01 01 01 01 01 01 15 02 17 01 01 01 01 01 01 01 15 02 17 01
01 15 16 17 01 01 01 01 01 01 01 15 16 17 01 01 01 01 01 01 01 01 01 15 16 17 01 01 01 15 16 17 01 01 01 01 01 01 01 01 01 15 16 17 01 01 01 01 01 01 01 15 16 17 01
01 15 02 17 01 01 01 01 01 01 01 15 02 17 01 01 01 01 01 01 01 01 01 15 02 17 01 01 01 15 02 17 01 01 01 01 01 01 01 01 01 15 02 17 01 01 01 01 01 01 01 15 02 17 01
01 15 16 32 25 25 25 36 01 01 01 15 16 32 25 25 25 25 25 25 25 25 25 31 16 32 25 25 25 31 16 32 25 25 25 25 25 25 25 25 25 31 16 17 01 01 01 35 25 25 25 31 16 17 01
01 15 02 26 02 26 02 17 01 01 01 15 02 26 02 26 02 26 02 26 02 26 02 26 02 26 02 26 02 26 02 26 02 26 02 26 02 26 02 26 02 26 02 17 01 01 01 15 02 26 02 26 02 17 01
01 38 27 27 27 34 16 17 01 01 01 15 16 33 27 27 27 34 16 33 27 27 27 27 27 27 27 27 27 27 27 27 27 27 27 34 16 33 27 27 27 34 16 17 01 01 01 15 16 33 27 27 27 37 01 
01 01 01 01 01 15 02 17 01 01 01 15 02 17 01 01 01 15 02 17 01 01 01 01 01 01 01 01 01 01 01 01 01 01 01 15 02 17 01 01 01 15 02 17 01 01 01 15 02 17 01 01 01 01 01
01 01 01 01 01 15 16 17 01 01 01 15 16 17 01 01 01 15 16 17 01 01 01 01 01 01 01 01 01 01 01 01 01 01 01 15 16 17 01 01 01 15 16 17 01 01 01 15 16 17 01 01 01 01 01
01 01 01 01 01 15 02 17 01 01 01 15 02 17 01 01 01 15 02 17 01 01 01 01 01 01 01 01 01 01 01 01 01 01 01 15 02 17 01 01 01 15 02 17 01 01 01 15 02 17 01 01 01 01 01
01 35 25 25 25 31 16 32 25 25 25 31 16 17 01 01 01 15 16 32 25 25 25 25 25 36 01 01 01 35 25 25 25 25 25 31 16 17 01 01 01 15 16 32 25 25 25 31 16 32 25 25 25 36 01
01 15 02 26 02 26 02 26 02 26 02 26 02 17 01 01 01 15 02 26 02 26 02 26 02 17 01 01 01 15 02 26 02 26 02 26 02 17 01 01 01 15 02 26 02 26 02 26 02 26 02 26 02 17 01
01 15 16 33 27 27 27 27 27 27 27 27 27 37 01 01 01 38 27 27 27 27 27 34 16 17 01 01 01 15 16 33 27 27 27 27 27 37 01 01 01 38 27 27 27 27 27 27 27 27 27 34 16 17 01
01 15 02 17 01 01 01 01 01 01 01 01 01 01 01 01 01 01 01 01 01 01 01 15 02 17 01 01 01 15 02 17 01 01 01 01 01 01 01 01 01 01 01 01 01 01 01 01 01 01 01 15 02 17 01
01 15 16 17 01 01 01 01 01 01 01 01 01 01 01 01 01 01 01 01 01 01 01 15 16 17 01 01 01 15 16 17 01 01 01 01 01 01 01 01 01 01 01 01 01 01 01 01 01 01 01 15 16 17 01
01 15 02 17 01 01 01 01 01 01 01 01 01 01 01 01 01 01 01 01 01 01 01 15 02 17 01 01 01 15 02 17 01 01 01 01 01 01 01 01 01 01 01 01 01 01 01 01 01 01 01 15 02 17 01
01 15 16 32 25 25 25 25 25 25 25 25 25 25 25 25 25 25 25 25 25 25 25 31 16 32 25 25 25 31 16 32 25 25 25 25 25 25 25 25 25 25 25 25 25 25 25 25 25 25 25 31 16 17 01
01 15 02 26 02 26 02 26 02 26 02 26 02 26 02 26 02 26 02 26 02 26 02 26 02 26 02 26 02 26 02 26 02 26 02 26 02 26 02 26 02 26 02 26 02 26 02 26 02 26 02 26 02 17 01
01 38 27 27 27 27 27 27 27 27 27 27 27 27 27 27 27 27 27 27 27 27 27 27 27 27 27 27 27 27 27 27 27 27 27 27 27 27 27 27 27 27 27 27 27 27 27 27 27 27 27 27 27 37 01
01 01 01 01 01 01 01 01 01 01 01 01 01 01 01 01 01 01 01 01 01 01 01 01 01 01 01 01 01 01 01 01 01 01 01 01 01 01 01 01 01 01 01 01 01 01 01 01 01 01 01 01 01 01 01