01 01 01 01 01 01 01 01 01 01 01 01 01 01 01 01 01 01 01 01 01 01 01 01 01 01 01 01 01 01 01 01 01 01 01 01 01 01 01 01 01 01 01 01 01 01 01 01 01 01 01 01 01 01 01 01 01 01 01 01 01 01 01 01 01 01
01 35 25 25 25 25 25 25 25 25 25 25 25 25 25 25 25 25 25 25 25 25 25 25 25 25 25 25 25 25 36 01 01 01 01 00 00 00 00 00 00 00 00 00 00 00 00 00 00 00 00 00 00 00 00 00 00 00 00 00 00 00 00 00 00 01
01 15 02 26 02 26 02 26 02 26 02 26 02 26 26 26 26 26 26 26 26 26 26 26 26 26 26 26 26 26 17 01 01 01 01 00 02 00 00 02 00 02 00 02 00 02 00 02 00 02 00 02 00 02 00 02 00 02 00 02 00 02 00 02 00 01
01 15 16 33 27 27 27 27 27 27 27 34 16 33 27 27 27 27 27 27 27 27 27 27 27 27 27 27 34 16 17 01 01 01 01 00 00 00 00 00 00 00 00 00 00 00 00 00 00 00 00 00 00 00 00 00 00 00 00 00 00 00 00 00 00 01
01 15 02 17 01 01 01 01 01 01 01 15 02 17 01 01 01 01 01 01 01 01 01 01 01 01 01 01 15 16 17 01 01 01 01 00 02 00 01 01 01 01 01 01 01 01 01 01 01 01 00 02 00 01 01 01 01 01 01 01 01 01 00 02 00 01
01 15 16 17 01 01 01 01 01 01 01 15 16 17 01 01 01 01 01 01 01 01 01 01 01 01 01 01 15 16 17 01 01 01 01 00 00 00 01 01 01 01 01 01 01 01 01 01 01 01 00 00 00 01 01 01 01 01 01 01 01 01 00 00 00 01
01 15 02 17 01 01 01 01 01 01 01 15 02 17 01 01 01 01 01 01 01 01 01 01 01 01 01 01 15 16 17 01 01 01 01 00 02 00 01 01 01 01 01 01 01 01 01 01 01 01 00 02 00 01 01 01 01 01 01 01 01 01 00 02 00 01
01 15 16 17 01 01 01 01 01 01 01 15 16 17 01 01 01 01 01 01 01 01 01 01 01 01 01 01 15 16 17 01 01 01 01 00 00 00 01 01 01 01 01 01 01 01 01 01 01 01 00 00 00 01 01 01 01 01 01 01 01 01 00 00 00 01
01 15 02 17 01 01 01 01 01 01 01 15 02 17 01 01 01 01 01 01 01 01 01 01 01 01 01 01 15 16 17 01 01 01 01 00 02 00 01 01 01 01 01 01 01 01 01 01 01 01 00 02 00 01 01 01 01 01 01 01 01 01 00 02 00 01
01 15 16 32 25 25 25 25 25 25 25 31 16 32 25 25 25 25 25 25 25 25 25 25 25 25 25 25 31 16 32 00 00 00 00 00 00 00 00 00 00 00 00 00 00 00 00 00 00 00 00 00 00 00 00 00 00 00 00 00 00 00 00 00 00 01
01 15 02 26 02 26 02 26 02 26 02 26 02 26 26 26 26 26 26 26 26 26 26 26 26 26 26 26 26 26 26 02 00 00 02 00 02 00 02 00 00 02 00 02 00 02 00 02 00 02 00 02 00 02 00 02 00 02 00 02 00 02 00 02 00 01
01 15 16 33 27 27 27 27 27 27 27 27 27 34 16 33 27 27 27 27 27 27 27 27 27 27 27 27 27 27 27 00 00 00 00 00 00 00 00 00 00 00 00 00 00 00 00 00 00 00 00 00 00 00 00 00 00 00 00 00 00 00 00 00 00 01
01 15 16 17 01 01 01 01 01 01 01 01 01 15 16 17 01 01 01 01 01 00 02 00 01 01 01 01 01 01 01 01 01 01 01 01 01 01 01 01 01 01 00 02 00 01 01 01 01 01 00 02 00 01 01 01 01 01 01 01 01 01 00 02 00 01
01 15 16 17 01 01 01 01 01 01 01 01 01 15 16 17 01 01 01 01 01 00 00 00 01 01 01 01 01 01 01 01 01 01 01 01 01 01 01 01 01 01 00 00 00 01 01 01 01 01 00 00 00 01 01 01 01 01 01 01 01 01 00 00 00 01
01 15 16 17 01 01 01 01 01 01 01 01 01 15 16 17 01 01 01 01 01 00 00 00 01 01 01 01 01 01 01 01 01 01 01 01 01 01 01 01 01 01 00 00 00 01 01 01 01 01 00 00 00 01 01 01 01 01 01 01 01 01 00 00 00 01
01 15 16 17 01 01 01 01 01 01 01 01 01 15 16 17 01 01 01 01 01 00 02 00 01 01 01 01 01 01 01 01 01 01 01 01 01 01 01 01 01 01 00 02 00 01 01 01 01 01 00 02 00 01 01 01 01 01 01 01 01 01 00 02 00 01
01 15 16 32 25 25 25 25 25 25 25 25 25 31 16 17 01 01 01 01 01 00 00 00 00 00 00 00 00 00 00 01 01 01 01 00 00 00 00 00 00 00 00 00 00 01 01 01 01 01 00 00 00 00 00 00 00 00 00 00 00 00 00 00 00 01
01 15 16 16 16 16 16 16 16 16 16 16 16 16 16 17 01 01 01 01 01 00 02 00 02 00 00 02 00 02 00 01 01 01 01 00 02 00 02 00 00 02 00 02 00 01 01 01 01 01 00 02 00 02 00 02 00 02 00 02 00 02 00 02 00 01
01 15 27 27 27 27 27 27 27 27 27 27 27 34 16 17 01 01 01 01 01 00 00 00 00 00 00 00 00 00 00 01 01 01 01 00 00 00 00 00 00 00 00 00 00 01 01 01 01 01 00 00 00 00 00 00 00 00 00 00 00 00 00 00 00 01
01 01 01 01 01 01 01 01 01 01 01 01 01 00 02 00 01 01 01 01 01 01 01 01 01 01 01 01 00 02 00 01 01 01 01 00 02 00 01 01 01 01 01 01 01 01 01 01 01 01 00 02 00 01 01 01 01 01 01 01 01 01 01 01 01 01
01 01 01 01 01 01 01 01 01 01 01 01 01 00 00 00 01 01 01 01 01 01 01 01 01 01 01 01 00 00 00 01 01 01 01 00 00 00 01 01 01 01 01 01 01 01 01 01 01 01 00 00 00 01 01 01 01 01 01 01 01 01 01 01 01 01
01 01 01 01 01 01 01 01 01 01 01 01 01 00 02 00 01 01 01 01 01 01 01 01 01 01 01 01 00 02 00 01 01 01 01 00 02 00 01 01 01 01 01 01 01 01 01 01 01 01 00 02 00 01 01 01 01 01 01 01 01 01 01 01 01 01
01 01 01 01 01 01 01 01 01 01 01 01 01 00 00 00 01 01 01 01 01 00 00 00 00 00 00 00 00 00 00 00 00 00 00 00 00 00 00 00 00 00 00 00 00 01 01 01 01 01 00 00 00 01 01 01 01 01 01 01 01 01 01 01 01 01
01 01 01 01 01 01 01 01 01 01 01 01 01 00 02 00 01 01 01 01 01 00 02 00 02 00 00 02 00 02 00 02 00 00 02 00 02 00 02 00 00 02 00 02 00 01 01 01 01 01 00 02 00 01 01 01 01 01 01 01 01 01 01 01 01 01
01 01 01 01 01 01 01 01 01 01 01 01 01 00 00 00 01 01 01 01 01 00 00 00 00 00 00 00 00 00 00 00 00 00 00 00 00 00 00 00 00 00 00 00 00 01 01 01 01 01 00 00 00 01 01 01 01 01 01 01 01 01 01 01 01 01
01 01 01 01 01 01 01 01 01 01 01 01 01 00 02 00 01 01 01 01 01 00 02 00 01 01 01 01 01 01 01 01 01 01 01 01 01 01 01 01 01 01 00 02 00 01 01 01 01 01 00 02 00 01 01 01 01 01 01 01 01 01 01 01 01 01
01 01 01 01 01 01 01 01 01 01 01 01 01 00 00 00 01 01 01 01 01 00 00 00 01 01 01 01 01 01 01 01 01 01 01 01 01 01 01 01 01 01 00 00 00 01 01 01 01 01 00 00 00 01 01 01 01 01 01 01 01 01 01 01 01 01
01 01 01 01 01 01 01 01 01 01 01 01 01 00 02 00 01 01 01 01 01 00 02 00 01 01 00 00 00 00 00 00 00 00 00 00 00 00 00 00 01 01 00 02 00 01 01 01 01 01 00 02 00 01 01 01 01 01 01 01 01 01 01 01 01 01
01 01 01 01 01 01 01 01 01 01 01 01 01 00 00 00 00 00 00 00 00 00 00 00 01 01 00 00 00 00 00 00 00 00 00 00 00 00 00 00 01 01 00 00 00 00 00 00 00 00 00 00 00 01 01 01 01 01 01 01 01 01 01 01 01 01
01 01 01 01 01 01 01 01 01 01 01 01 01 00 02 00 02 00 02 00 02 00 02 00 01 01 00 00 00 00 00 00 00 00 00 00 00 00 00 00 01 01 00 02 00 02 00 02 00 02 00 02 00 01 01 01 01 01 01 01 01 01 01 01 01 01
01 01 01 01 01 01 01 01 01 01 01 01 01 00 00 00 00 00 00 00 00 00 00 00 01 01 00 00 00 00 00 00 00 00 00 00 00 00 00 00 01 01 00 00 00 00 00 00 00 00 00 00 00 01 01 01 01 01 01 01 01 01 01 01 01 01
01 01 01 01 01 01 01 01 01 01 01 01 01 00 02 00 01 01 01 01 01 00 02 00 01 01 00 00 00 00 00 00 00 00 00 00 00 00 00 00 01 01 00 02 00 01 01 01 01 01 00 02 00 01 01 01 01 01 01 01 01 01 01 01 01 01
01 01 01 01 01 01 01 01 01 01 01 01 01 00 00 00 01 01 01 01 01 00 00 00 01 01 00 00 00 00 00 00 00 00 00 00 00 00 00 00 01 01 00 00 00 01 01 01 01 01 00 00 00 01 01 01 01 01 01 01 01 01 01 01 01 01
01 01 01 01 01 01 01 01 01 01 01 01 01 00 02 00 01 01 01 01 01 00 02 00 01 01 01 01 01 01 01 01 01 01 01 01 01 01 01 01 01 01 00 02 00 01 01 01 01 01 00 02 00 01 01 01 01 01 01 01 01 01 01 01 01 01
01 01 01 01 01 01 01 01 01 01 01 01 01 00 00 00 01 01 01 01 01 00 00 00 01 01 01 01 01 01 01 01 01 01 01 01 01 01 01 01 01 01 00 00 00 01 01 01 01 01 00 00 00 01 01 01 01 01 01 01 01 01 01 01 01 01
01 01 01 01 01 01 01 01 01 01 01 01 01 00 02 00 01 01 01 01 01 00 00 00 00 00 00 00 00 00 00 00 00 00 00 00 00 00 00 00 00 00 00 00 00 01 01 01 01 01 00 02 00 01 01 01 01 01 01 01 01 01 01 01 01 01
01 01 01 01 01 01 01 01 01 01 01 01 01 00 00 00 01 01 01 01 01 00 02 00 00 02 00 00 02 00 00 02 00 00 02 00 00 02 00 00 02 00 00 02 00 01 01 01 01 01 00 00 00 01 01 01 01 01 01 01 01 01 01 01 01 01
01 01 01 01 01 01 01 01 01 01 01 01 01 00 02 00 01 01 01 01 01 00 00 00 00 00 00 00 00 00 00 00 00 00 00 00 00 00 00 00 00 00 00 00 00 01 01 01 01 01 00 02 00 01 01 01 01 01 01 01 01 01 01 01 01 01
01 01 01 01 01 01 01 01 01 01 01 01 01 00 00 00 01 01 01 01 01 00 02 00 01 01 01 01 01 01 01 01 01 01 01 01 01 01 01 01 01 01 00 00 00 01 01 01 01 01 00 00 00 01 01 01 01 01 01 01 01 01 01 01 01 01
01 01 01 01 01 01 01 01 01 01 01 01 01 00 02 00 01 01 01 01 01 00 00 00 01 01 01 01 01 01 01 01 01 01 01 01 01 01 01 01 01 01 00 02 00 01 01 01 01 01 00 02 00 01 01 01 01 01 01 01 01 01 01 01 01 01
01 01 01 01 01 01 01 01 01 01 01 01 01 00 00 00 01 01 01 01 01 00 02 00 01 01 01 01 01 01 01 01 01 01 01 01 01 01 01 01 01 01 00 00 00 01 01 01 01 01 00 00 00 01 01 01 01 01 01 01 01 01 01 01 01 01
01 00 00 00 00 00 00 00 00 00 00 00 00 00 00 00 00 00 00 00 00 00 00 00 00 00 00 00 00 00 00 01 01 01 01 00 00 00 00 00 00 00 00 00 00 00 00 00 00 00 00 00 00 00 00 00 00 00 00 00 00 00 00 00 00 01
01 00 02 00 02 00 02 00 02 00 02 00 02 00 02 00 02 00 02 00 02 00 02 00 02 00 02 00 00 02 00 01 01 01 01 00 02 00 02 00 00 02 00 02 00 02 00 02 00 02 00 02 00 02 00 02 00 02 00 02 00 02 00 02 00 01
01 00 00 00 00 00 00 00 00 00 00 00 00 00 00 00 00 00 00 00 00 00 00 00 00 00 00 00 00 00 00 01 01 01 01 00 00 00 00 00 00 00 00 00 00 00 00 00 00 00 00 00 00 00 00 00 00 00 00 00 00 00 00 00 00 01
01 00 02 00 01 01 01 01 01 01 01 01 01 00 02 00 01 01 01 01 01 01 01 01 01 01 01 01 00 02 00 01 01 01 01 00 02 00 01 01 01 01 01 01 01 01 01 01 01 01 00 02 00 01 01 01 01 01 01 01 01 01 00 02 00 01
01 00 00 00 01 01 01 01 01 01 01 01 01 00 00 00 01 01 01 01 01 01 01 01 01 01 01 01 00 00 00 01 01 01 01 00 00 00 01 01 01 01 01 01 01 01 01 01 01 01 00 00 00 01 01 01 01 01 01 01 01 01 00 00 00 01
01 00 02 00 01 01 01 01 01 01 01 01 01 00 02 00 01 01 01 01 01 01 01 01 01 01 01 01 00 02 00 01 01 01 01 00 02 00 01 01 01 01 01 01 01 01 01 01 01 01 00 02 00 01 01 01 01 01 01 01 01 01 00 02 00 01
01 00 00 00 00 00 00 00 00 01 01 01 01 00 00 00 00 00 00 00 00 00 00 00 00 00 00 00 00 00 00 00 00 00 00 00 00 00 00 00 00 00 00 00 00 00 00 00 00 00 00 00 00 01 01 01 01 00 00 00 00 00 00 00 00 01
01 00 02 00 00 02 00 02 00 01 01 01 01 00 02 00 02 00 02 00 02 00 02 00 02 00 00 02 00 02 00 02 00 00 02 00 02 00 02 00 00 02 00 02 00 02 00 02 00 02 00 02 00 01 01 01 01 00 02 00 02 00 00 02 00 01
01 00 00 00 00 00 00 00 00 01 01 01 01 00 00 00 00 00 00 00 00 00 00 00 00 00 00 00 00 00 00 00 00 00 00 00 00 00 00 00 00 00 00 00 00 00 00 00 00 00 00 00 00 01 01 01 01 00 00 00 00 00 00 00 00 01
01 01 01 01 01 01 00 02 00 01 01 01 01 00 02 00 01 01 01 01 01 00 02 00 01 01 01 01 01 01 01 01 01 01 01 01 01 01 01 01 01 01 00 02 00 01 01 01 01 01 00 02 00 01 01 01 01 00 02 00 01 01 01 01 01 01
01 01 01 01 01 01 00 00 00 01 01 01 01 00 00 00 01 01 01 01 01 00 00 00 01 01 01 01 01 01 01 01 01 01 01 01 01 01 01 01 01 01 00 00 00 01 01 01 01 01 00 00 00 01 01 01 01 00 00 00 01 01 01 01 01 01
01 01 01 01 01 01 00 00 00 01 01 01 01 00 00 00 01 01 01 01 01 00 00 00 01 01 01 01 01 01 01 01 01 01 01 01 01 01 01 01 01 01 00 00 00 01 01 01 01 01 00 00 00 01 01 01 01 00 00 00 01 01 01 01 01 01
01 01 01 01 01 01 00 02 00 01 01 01 01 00 02 00 01 01 01 01 01 00 02 00 01 01 01 01 01 01 01 01 01 01 01 01 01 01 01 01 01 01 00 02 00 01 01 01 01 01 00 02 00 01 01 01 01 00 02 00 01 01 01 01 01 01
01 00 00 00 00 00 00 00 00 00 00 00 00 00 00 00 01 01 01 01 01 00 00 00 00 00 00 00 00 00 00 01 01 01 01 00 00 00 00 00 00 00 00 00 00 01 01 01 01 01 00 00 00 00 00 00 00 00 00 00 00 00 00 00 00 01
01 00 02 00 00 02 00 02 00 02 00 00 02 00 02 00 01 01 01 01 01 00 02 00 02 00 00 02 00 02 00 01 01 01 01 00 02 00 02 00 00 02 00 02 00 01 01 01 01 01 00 02 00 02 00 00 02 00 02 00 02 00 00 02 00 01
01 00 00 00 00 00 00 00 00 00 00 00 00 00 00 00 01 01 01 01 01 00 00 00 00 00 00 00 00 00 00 01 01 01 01 00 00 00 00 00 00 00 00 00 00 01 01 01 01 01 00 00 00 00 00 00 00 00 00 00 00 00 00 00 00 01
01 00 02 00 01 01 01 01 01 01 01 01 01 01 01 01 01 01 01 01 01 01 01 01 01 01 01 01 00 02 00 01 01 01 01 00 02 00 01 01 01 01 01 01 01 01 01 01 01 01 01 01 01 01 01 01 01 01 01 01 01 01 00 02 00 01
01 00 00 00 01 01 01 01 01 01 01 01 01 01 01 01 01 01 01 01 01 01 01 01 01 01 01 01 00 00 00 01 01 01 01 00 00 00 01 01 01 01 01 01 01 01 01 01 01 01 01 01 01 01 01 01 01 01 01 01 01 01 00 00 00 01
01 00 02 00 01 01 01 01 01 01 01 01 01 01 01 01 01 01 01 01 01 01 01 01 01 01 01 01 00 02 00 01 01 01 01 00 02 00 01 01 01 01 01 01 01 01 01 01 01 01 01 01 01 01 01 01 01 01 01 01 01 01 00 02 00 01
01 00 00 00 00 00 00 00 00 00 00 00 00 00 00 00 00 00 00 00 00 00 00 00 00 00 00 00 00 00 00 00 00 00 00 00 00 00 00 00 00 00 00 00 00 00 00 00 00 00 00 00 00 00 00 00 00 00 00 00 00 00 00 00 00 01
01 00 02 00 00 02 00 00 02 00 00 02 00 00 02 00 00 02 00 00 02 00 00 02 00 00 02 00 00 02 00 02 00 00 02 00 02 00 00 02 00 00 02 00 00 02 00 00 02 00 00 02 00 00 02 00 00 02 00 00 02 00 00 02 00 01
01 00 00 00 00 00 00 00 00 00 00 00 00 00 00 00 00 00 00 00 00 00 00 00 00 00 00 00 00 00 00 00 00 00 00 00 00 00 00 00 00 00 00 00 00 00 00 00 00 00 00 00 00 00 00 00 00 00 00 00 00 00 00 00 00 01
01 01 01 01 01 01 01 01 01 01 01 01 01 01 01 01 01 01 01 01 01 01 01 01 01 01 01 01 01 01 01 01 01 01 01 01 01 01 01 01 01 01 01 01 01 01 01 01 01 01 01 01 01 01 01 01 01 01 01 01 01 01 01 01 01 01